______________________________________
______________________________________
______________________________________
______________________________________
______________________________________
______________________________________
______________________________________
______________________________________
______________________________________
______________________________________
______________________________________
______________________________________
______________________________________
___________#################__________
___________#S      # # # # #__________
___________####### # #   # E__________
___________# #     # # # # #__________
___________# # ##### # # # #__________
___________# #       # # # #__________
___________# #### #### # # #__________
___________#           #   #__________
___________#################__________
______________________________________
______________________________________
______________________________________
______________________________________
______________________________________
______________________________________
______________________________________
______________________________________