________________________________________
________________________________________
________________________________________
________________________________________
________________________________________
________________________________________
________________________________________
________________________________________
________________________________________
________________________________________
________________________________________
________________________________________
________________________________________
___________#################____________
___________#S      # # # # #____________
___________####### # #   # E____________
___________# #     # # # # #____________
___________# # ##### # # # #____________
___________# #       # # # #____________
___________# #### #### # # #____________
___________#           #   #____________
___________#################____________
________________________________________
________________________________________
________________________________________
________________________________________
________________________________________
________________________________________
________________________________________
________________________________________