________________________________________
________________________________________
________________________________________
________________________________________
________________________________________
________________________________________
________________________________________
________________________________________
________________________________________
________________________________________
_________##################_____________
_________###   #   #   ####_____________
_________### # # # # # ####_____________
_________### # # # # # ####_____________
_________### # # # # # ####_____________
_________#S  F   F   F    E_____________
_________### # # # # # ####_____________
_________### # # # # # ####_____________
_________### # # # # # ####_____________
_________###   #   #   ####_____________
_________##################_____________
________________________________________
________________________________________
________________________________________
________________________________________
________________________________________
________________________________________
________________________________________
________________________________________
________________________________________