________________________________________
________________________________________
________________________________________
________________________________________
________________________________________
________________________________________
________________________________________
________________________________________
________________________________________
________________________________________
___________#############________________
___________#   #   #   #________________
___________# # # # # # #________________
___________# # # # # # #________________
_________### # # # # # ####_____________
_________#S  F   F   F    E_____________
_________### # # # # # ####_____________
___________# # # # # # #________________
___________# # # # # # #________________
___________#   #   #   #________________
___________#############________________
________________________________________
________________________________________
________________________________________
________________________________________
________________________________________
________________________________________
________________________________________
________________________________________
________________________________________